XXXXXXXXXXXXXXX
X143534234556XX
X3432XXaXXXX12X   
X142316732XXXbX         
X2453345234XXXX
X1XXcXXXXXXXXXX
X34327647243d2X
XXXXXXXXXXXXXXX
